111111111
10E000P01
10C01C001
111111111
