1111111111111
100000CE00001
111P000000C11
1000000000000
1111111111100