111111111
10E010P01
10C01C001
111111111
